
{
"name":"demo",

"world":[
[1,0,1,0,1,0,0,1,0,0,1,0,0,1,0,0,1,0,0,0],
[0,1,0,0,1,0,0,1,0,0,1,0,0,1,0,0,1,0,0,0],
[0,1,0,0,1,0,0,1,0,0,1,0,0,1,0,0,1,0,0,0],
[0,1,0,0,1,0,0,1,0,0,1,0,0,1,0,0,1,0,0,0],
[0,1,0,0,1,0,0,1,0,0,1,0,0,1,0,0,1,0,0,0],
[0,1,0,0,1,0,0,1,0,0,1,0,0,1,0,0,1,0,0,0],
[0,1,0,0,1,0,0,1,0,0,1,0,0,1,0,0,1,0,0,0],
[0,1,0,0,1,0,0,1,0,0,1,0,0,1,0,0,1,0,0,0],
[0,1,0,0,1,0,0,1,0,0,1,0,0,1,0,0,1,0,0,0],
[0,1,0,0,1,0,0,1,0,0,1,0,0,1,0,0,1,0,0,0],
[0,1,0,0,1,0,0,1,0,0,1,0,0,1,0,0,1,0,0,0]],

"tiles":[
[1,0,1,0,1,0,0,1,0,0,1,0,0,1,0,0,1,0,0,0],
[0,1,0,0,1,0,0,1,0,0,1,0,0,1,0,0,1,0,0,0],
[0,1,0,0,1,0,0,1,0,0,1,0,0,1,0,0,1,0,0,0],
[0,1,0,0,1,0,0,1,0,0,1,0,0,1,0,0,1,0,0,0],
[0,1,0,0,1,0,0,1,0,0,1,0,0,1,0,0,1,0,0,0],
[0,1,0,0,1,0,0,1,0,0,1,0,0,1,0,0,1,0,0,0],
[0,1,0,0,1,0,0,1,0,0,1,0,0,1,0,0,1,0,0,0],
[0,1,0,0,1,0,0,1,0,0,1,0,0,1,0,0,1,0,0,0],
[0,1,0,0,1,0,0,1,0,0,1,0,0,1,0,0,1,0,0,0],
[0,1,0,0,1,0,0,1,0,0,1,0,0,1,0,0,1,0,0,0],
[0,1,0,0,1,0,0,1,0,0,1,0,0,1,0,0,1,0,0,0]],

"entities":[
[0,0,2,0,0,0,0,0,0,0,0,0,0,0,0,0,0,0,0,0],
[0,0,0,0,0,0,0,0,0,0,0,0,0,0,0,0,0,0,0,0],
[0,0,0,0,0,0,0,0,0,0,0,0,0,0,0,0,0,0,0,0],
[0,0,0,0,0,0,0,0,0,0,0,0,0,0,0,0,0,0,0,0],
[0,0,0,0,0,0,0,0,0,0,0,0,0,0,0,0,0,0,0,0],
[0,0,0,0,0,0,0,0,0,0,0,0,0,0,0,0,0,0,0,0],
[0,0,0,0,0,0,0,0,0,0,0,0,0,0,0,0,0,0,0,0],
[0,0,0,0,0,0,0,0,0,0,0,0,0,0,0,0,0,0,0,0],
[0,0,0,0,0,0,0,0,0,0,0,0,0,0,0,0,0,0,0,0],
[0,0,0,0,0,0,0,0,0,0,0,0,0,0,0,0,0,0,0,0],
[0,0,0,0,0,0,0,0,0,0,0,0,0,0,0,0,0,0,0,0]],

"units":[],
"effects":[]

}

