
{
"name":"forest",

"world":[
[ 2, 2, 2, 0, 0, 0, 0, 0, 0, 0, 0, 0, 0, 0, 0, 0, 0, 0, 0, 0, 0, 0, 0, 0, 0],
[ 2, 2, 0, 0, 0, 0, 0, 0, 0, 0, 0, 0, 0, 0, 0, 0, 0, 0, 5, 0, 0, 0, 0, 0, 0],
[ 2, 2, 0, 0, 0, 0, 0, 0, 0, 0, 0, 0, 0, 0, 0, 0, 0, 5, 5, 5, 0, 0, 0, 0, 0],
[ 2, 2, 2, 0, 0, 0, 0, 0, 0, 0, 0, 0, 5, 5, 0, 0, 5, 5, 5, 5, 5, 0, 0, 0, 0],
[ 2, 2, 2, 0, 0, 0, 0, 0, 0, 0, 0, 5, 5, 5, 0, 0, 0, 5, 5, 5, 5, 0, 0, 0, 0],
[ 2, 2, 2, 0, 0, 0, 0, 0, 0, 0, 0, 5, 5, 5, 0, 0, 0, 0, 5, 5, 5, 5, 0, 0, 0],
[ 2, 2, 2, 0, 0, 0, 0, 0, 0, 0, 0, 0, 5, 5, 0, 0, 0, 0, 0, 0, 5, 5, 5, 0, 0],
[ 2, 2, 2, 0, 0, 0, 0, 0, 0, 0, 0, 0, 0, 5, 0, 0, 5, 0, 0, 0, 5, 5, 5, 5, 0],
[ 2, 2, 2, 0, 5, 0, 0, 0, 0, 0, 0, 0, 0, 0, 0, 0, 5, 5, 0, 0, 0, 5, 5, 0, 0],
[ 2, 2, 2, 0, 5, 5, 0, 0, 0, 5, 0, 0, 0, 0, 0, 0, 5, 5, 0, 0, 0, 5, 0, 0, 0],
[ 2, 2, 2, 0, 5, 0, 0, 0, 0, 5, 5, 0, 0, 0, 0, 0, 5, 5, 0, 0, 0, 0, 0, 0, 0],
[ 2, 2, 2, 0, 0, 0, 0, 0, 0, 5, 5, 0, 0, 0, 0, 0, 0, 5, 5, 0, 0, 0, 0, 0, 0],
[ 2, 2, 2, 0, 0, 0, 0, 0, 0, 5, 5, 0, 0, 0, 0, 0, 0, 5, 5, 0, 0, 0, 0, 0, 0],
[ 2, 2, 2, 0, 0, 5, 5, 0, 0, 5, 5, 0, 5, 5, 5, 5, 0, 0, 5, 5, 0, 0, 0, 0, 0],
[ 2, 2, 2, 0, 0, 5, 5, 0, 0, 0, 0, 0, 0, 0, 0, 5, 0, 0, 0, 5, 5, 0, 0, 0, 0],
[ 2, 2, 2, 2, 0, 0, 5, 5, 0, 0, 0, 0, 5, 0, 0, 5, 0, 0, 0, 0, 5, 5, 0, 0, 0],
[ 2, 2, 2, 2, 0, 0, 0, 5, 5, 5, 5, 5, 5, 0, 0, 5, 0, 0, 0, 0, 0, 5, 5, 0, 0],
[ 2, 2, 2, 2, 2, 0, 0, 0, 0, 0, 0, 0, 0, 0, 1, 0, 0, 0, 0, 0, 0, 0, 5, 5, 0],
[ 2, 2, 2, 2, 2, 2, 0, 0, 0, 0, 0, 0, 0, 1, 1, 1, 0, 0, 0, 0, 0, 0, 0, 5, 0],
[ 2, 2, 2, 2, 2, 2, 2, 2, 0, 0, 0, 0, 0, 0, 1, 1, 1, 0, 0, 0, 0, 0, 0, 5, 0],
[ 0, 2, 2, 2, 2, 2, 2, 2, 2, 2, 0, 0, 0, 0, 0, 0, 0, 0, 0, 0, 0, 5, 0, 5, 0],
[ 0, 0, 0, 0, 0, 2, 2, 2, 2, 2, 0, 0, 0, 0, 0, 0, 0, 0, 0, 0, 0, 5, 5, 5, 0],
[ 0, 0, 0, 0, 0, 0, 0, 0, 2, 2, 2, 0, 0, 0, 0, 0, 0, 0, 0, 0, 0, 5, 5, 5, 0],
[ 0, 0, 0, 0, 0, 0, 0, 0, 0, 2, 2, 2, 2, 2, 0, 0, 0, 0, 0, 0, 0, 0, 5, 5, 0],
[ 0, 0, 0, 0, 0, 0, 0, 0, 0, 2, 2, 2, 2, 2, 0, 0, 0, 0, 0, 0, 2, 2, 5, 5, 0]],

"tiles":[
[ 0, 0, 0, 0, 0, 3, 3, 3, 3, 3, 3, 3, 3, 3, 3, 3, 3, 3, 3, 3, 3, 3, 3, 3, 3],
[ 2, 2, 8, 3, 3, 3, 3, 3, 3, 3, 3,10, 3, 3, 3, 3, 3, 3, 5, 3, 3, 3, 3, 3, 3],
[ 2, 2, 8, 3, 3, 3, 3, 3, 3, 3, 3, 3, 3, 3, 3, 3, 3, 5, 5, 5, 3, 3, 3, 3, 3],
[ 2, 2, 2, 8, 3, 3, 3, 3, 3, 3, 3, 3, 5, 5, 3, 3, 5, 5, 5, 5, 5, 3, 3, 3, 3],
[ 2, 2, 2, 8, 3, 3, 3, 3, 3, 3, 3, 5, 5, 5, 3, 3, 3, 5, 5, 5, 5, 3, 3, 3, 3],
[ 2, 2, 2, 8, 3, 3, 3, 3, 3, 3, 3, 5, 5, 5, 3, 3, 3, 3, 5, 5, 5, 5, 3, 3, 3],
[ 2, 2, 2, 8, 3, 3, 3, 3, 3, 3, 3, 3, 5, 5, 3, 3, 3, 3, 3, 3, 5, 5, 5, 3, 3],
[ 2, 2, 2, 8, 3, 3, 3, 3, 3, 3, 3, 3, 3, 5, 3, 3, 5, 3, 3, 3, 5, 5, 5, 5, 3],
[ 2, 2, 2, 8, 5, 3, 3, 3, 3, 3, 3, 3, 3, 3, 3, 3, 5, 5, 3, 3, 3, 5, 5, 3, 3],
[ 2, 2, 2, 8, 5, 5, 3, 3, 3, 5, 3, 3, 3, 3, 3, 3, 5, 5, 3, 3, 3, 5, 3, 3, 3],
[ 2, 2, 2, 8, 5, 3, 3, 3, 3, 5, 5, 3, 3, 3, 3, 3, 5, 5, 3, 3, 3, 3, 3, 3, 3],
[ 2, 2, 2, 8, 3, 3, 3, 3, 3, 5, 5, 3, 3, 3, 3, 3, 3, 5, 5, 3, 3, 3, 3, 3, 3],
[ 2, 2, 2, 8, 3, 3, 3, 3, 3, 5, 5, 3, 3, 3, 3, 3, 3, 5, 5, 3, 3, 3, 3, 3, 3],
[ 2, 2, 2, 8, 3, 5, 5, 3, 3, 5, 5, 3, 5, 5, 5, 5, 3, 3, 5, 5, 3, 3, 3, 3, 3],
[ 2, 2, 2, 8, 3, 5, 5, 3, 3, 3, 3, 3, 3, 3, 3, 5, 3, 3, 3, 5, 5, 3, 3, 3, 3],
[ 2, 2, 2, 2, 8, 3, 5, 5, 3, 3, 3, 3, 5, 3, 3, 5, 3, 3, 3, 3, 5, 5, 3, 3, 3],
[ 2, 2, 2, 2, 8, 3, 3, 5, 5, 5, 5, 5, 5, 3, 3, 5, 3, 3, 3, 3, 3, 5, 5, 3, 3],
[ 2, 2, 2, 2, 2, 8, 3, 3, 3, 3, 3, 3, 3, 3, 1, 3, 3, 3, 3, 3, 3, 3, 5, 5, 3],
[ 0, 2, 2, 2, 2, 2, 8, 8, 3, 3, 3, 3, 3, 1, 1, 1, 3, 3, 3, 3, 3, 3, 3, 5, 3],
[ 0, 2, 2, 0, 2, 2, 2, 2, 8, 8, 3, 3, 3, 3, 1, 1, 1, 3, 3, 3, 3, 3, 3, 5, 3],
[ 0, 0, 2, 2, 2, 2, 2, 2, 2, 2, 8, 3, 3, 3, 3, 3, 3, 3, 3, 3, 3, 5, 3, 5, 3],
[ 0, 0, 8, 8, 8, 2, 2, 2, 2, 2, 8, 8, 3, 3, 3, 3, 3, 3, 3, 3, 3, 5, 5, 5, 3],
[ 0, 0, 3, 3, 3, 8, 8, 8, 2, 2, 2, 8, 8, 8, 8, 3, 3, 3, 3, 3, 3, 5, 5, 5, 3],
[ 0, 0, 3, 3, 3, 3, 3, 3, 8, 2, 2, 2, 2, 2, 8, 8, 8, 8, 8, 3, 8, 8, 5, 5, 3],
[ 0, 0, 3, 0, 3, 3, 3, 3, 8, 2, 2, 2, 2, 2, 8, 8, 8, 8, 8, 8, 2, 2, 5, 5, 3]],

"entities":[
[ 0, 0, 0, 0, 0, 0, 0, 0, 0, 0, 0, 0, 0, 0, 0, 0, 0, 0, 0, 0, 0, 0, 0, 0, 0],
[ 0, 0, 0, 0, 0, 0, 0, 0, 0, 0, 0,"home", 0, 0, 0, 0, 0, 0, 0, 0, 0, 0, 0, 0, 0],
[ 0, 0, 0, 0, 0, 0, 0, 0, 0, 0, 0, 0, 0, 0, 0, 0, 0, 0, 0, 0, 0, 0, 0, 0, 0],
[ 0, 0, 0, 0, 0, 0, 0, 0, 0, 0, 0, 0, 0, 0, 0, 0, 0, 0, 0, 0, 0, 0, 0, 0, 0],
[ 0, 0, 0, 0, 0, 0, 0, 0, 0, 0, 0, 0, 0, 0, 0, 0, 0, 0, 0, 0, 0, 0, 0, 0, 0],
[ 0, 0, 0, 0, 0, 0, 0, 0, 0, 0, 0, 0, 0, 0, 0, 0, 0, 0, 0, 0, 0, 0, 0, 0, 0],
[ 0, 0, 0, 0, 0, 0, 0, 0, 0, 0, 0, 0, 0, 0, 0, 0, 0, 0, 0, 0, 0, 0, 0, 0, 0],
[ 0, 0, 0, 0, 0, 0, 0, 0, 0, 0, 0, 0, 0, 0, 0, 0, 0, 0, 0, 0, 0, 0, 0, 0, 0],
[ 0, 0, 0, 0, 0, 0, 0, 0, 0, 0, 0, 0, 0, 0, 0, 0, 0, 0, 0, 0, 0, 0, 0, 0, 0],
[ 0, 0, 0, 0, 0, 0, 0, 0, 0, 0, 0, 0, 0, 0, 0, 0, 0, 0, 0, 0, 0, 0, 0, 0, 0],
[ 0, 0, 0, 0, 0, 0, 0, 0, 0, 0, 0, 0, 0, 0, 0, 0, 0, 0, 0, 0, 0, 0, 0, 0, 0],
[ 0, 0, 0, 0, 0, 0, 0, 0, 0, 0, 0, 0, 0, 0, 0, 0, 0, 0, 0, 0, 0, 0, 0, 0, 0],
[ 0, 0, 0, 0, 0, 0, 0, 0, 0, 0, 0, 0, 0, 0, 0, 0, 0, 0, 0, 0, 0, 0, 0, 0, 0],
[ 0, 0, 0, 0, 0, 0, 0, 0, 0, 0, 0, 0, 0, 0, 0, 0, 0, 0, 0, 0, 0, 0, 0, 0, 0],
[ 0, 0, 0, 0, 0, 0, 0, 0, 0, 0, 0, 0, 0, 0, 0, 0, 0, 0, 0, 0, 0, 0, 0, 0, 0],
[ 0, 0, 0, 0, 0, 0, 0, 0, 0, 0, 0, 0, 0, 0, 0, 0, 0, 0, 0, 0, 0, 0, 0, 0, 0],
[ 0, 0, 0, 0, 0, 0, 0, 0, 0, 0, 0, 0, 0, 0, 0, 0, 0, 0, 0, 0, 0, 0, 0, 0, 0],
[ 0, 0, 0, 0, 0, 0, 0, 0, 0, 0, 0, 0, 0, 0, 0, 0, 0, 0, 0, 0, 0, 0, 0, 0, 0],
[ 0, 0, 0, 0, 0, 0, 0, 4, 0, 0, 0, 0, 0, 0, 0, 0, 0, 0, 0, 0, 0, 0, 0, 0, 0],
[ 0, 0, 0, 0, 0, 0, 0, 0, 0, 0, 0, 0, 0, 0, 0, 0, 0, 0, 0, 0, 0, 0, 0, 0, 0],
[ 0, 0, 0, 0, 0, 0, 0, 0, 0, 0, 0, 0, 0, 0, 0, 0, 0, 0, 0, 0, 0, 0, 0, 0, 0],
[ 0, 0, 0, 0, 0, 0, 0, 0, 0, 0, 0, 0, 0, 0, 0, 0, 0, 0, 0, 0, 0, 0, 0, 0, 0],
[ 0, 0, 0, 0, 0, 0, 0, 0, 0, 0, 0, 0, 0, 0, 0, 0, 0, 0, 0, 0, 0, 0, 0, 0, 0],
[ 0, 0, 0, 0, 0, 0, 0, 0, 0, 0, 0, 0, 0, 0, 0, 0, 0, 0, 0, 4, 0, 0, 0, 0, 0],
[ 0, 0, 0, 0, 0, 0, 0, 0, 0, 0, 0, 0, 0, 0, 0, 0, 0, 0, 0, 0, 0, 0, 0, 0, 0]],

"units":[
 ["cheer",11, 20],
 ["grease",4,3],
 ["prep",20,10]
],
"effects":[]

}


