
{
"name":"mall",

"world":[
[7, 7, 7, 7, 7, 7, 7, 7, 7, 7, 7, 7, 7, 7, 7, 7, 7, 7, 7, 7, 7, 7, 7, 7, 7],
[7, 0, 0, 0, 0, 0, 0, 0, 0, 7, 0, 0, 0, 0, 0, 7, 0, 0, 0, 0, 7, 0, 0, 0, 7],
[7, 0, 0, 0, 0, 0, 0, 0, 0, 7, 0, 0, 0, 0, 0, 7, 0, 0, 0, 0, 7, 0, 0, 0, 7],
[7, 0, 0, 0, 0, 0, 0, 0, 0, 7, 0, 0, 0, 0, 0, 7, 0, 0, 0, 0, 7, 0, 0, 0, 7],
[7, 0, 0, 0, 0, 0, 0, 0, 0, 7, 0, 0, 0, 0, 0, 7, 0, 0, 0, 0, 7, 0, 0, 0, 7],
[7, 7, 7, 7, 7, 7, 7, 0, 0, 7, 7, 7, 0, 7, 7, 7, 7, 0, 0, 7, 7, 0, 0, 0, 7],
[7, 0, 0, 0, 0, 0, 7, 0, 0, 0, 0, 0, 0, 0, 0, 0, 0, 0, 0, 0, 0, 0, 0, 0, 7],
[7, 0, 0, 0, 0, 0, 7, 0, 0, 0, 0, 0, 0, 0, 0, 0, 0, 0, 0, 0, 0, 0, 0, 0, 7],
[7, 0, 0, 0, 0, 0, 7, 0, 0, 0, 0, 0, 0, 0, 0, 0, 0, 0, 0, 0, 7, 7, 7, 7, 7],
[7, 0, 0, 0, 0, 0, 7, 0, 0, 0, 0, 0, 0,  0, 0, 0, 0, 0, 0, 0, 7, 0, 0, 0, 7],
[7, 0, 0, 0, 0, 0, 0, 0, 0, 0, 0, 0,  0, 2,  0, 0, 0, 0, 0, 0, 0, 0, 0, 0, 7],
[7, 0, 0, 0, 0, 0, 0, 0, 0, 0, 0,  0, 2, 4, 2,  0, 0, 0, 0, 0, 0, 0, 0, 0, 7],
[7, 0, 0, 0, 0, 0, 7, 0, 0, 0, 0, 0,  0, 2,  0, 0, 0, 0, 0, 0, 7, 0, 0, 0, 7],
[7, 0, 0, 0, 0, 0, 7, 0, 0, 0, 0, 0, 0,  0, 0, 0, 0, 0, 0, 0, 7, 7, 7, 7, 7],
[7, 0, 0, 0, 0, 0, 7, 0, 0, 0, 0, 0, 0, 0, 0, 0, 0, 0, 0, 0, 7, 0, 0, 0, 7],
[7, 7, 7, 7, 7, 7, 7, 0, 0, 0, 0, 0, 0, 0, 0, 0, 0, 0, 0, 0, 7, 0, 0, 0, 7],
[7, 0, 0, 0, 0, 0, 7, 0, 0, 0, 0, 0, 0, 0, 0, 0, 0, 0, 0, 0, 0, 0, 0, 0, 7],
[7, 0, 0, 0, 0, 0, 7, 0, 0, 0, 0, 0, 0, 0, 0, 0, 0, 0, 0, 0, 7, 0, 0, 0, 7],
[7, 0, 0, 0, 0, 0, 7, 0, 0, 0, 0, 0, 0, 0, 0, 0, 0, 0, 0, 0, 7, 0, 0, 0, 7],
[7, 0, 0, 0, 0, 0, 0, 0, 0, 0, 0, 0, 0, 0, 0, 7, 7, 7, 0, 0, 7, 7, 7, 7, 7],
[7, 0, 0, 0, 0, 0, 0, 0, 7, 7, 0, 7, 0, 0, 0, 7, 9, 9, 9, 9, 9, 9, 9, 9, 7],
[7, 0, 0, 0, 0, 0, 7, 0, 7, 0, 0, 7, 0, 7, 0, 7, 9, 9, 9, 9, 9, 9, 9, 9, 7],
[7, 0, 0, 0, 0, 0, 7, 0, 7, 0, 0, 7, 0, 0, 0, 7, 9, 9, 9, 9, 9, 9, 9, 9, 7],
[7, 0, 0, 0, 0, 0, 0, 0, 0, 0, 0, 7, 0, 0, 0, 7, 9, 9, 9, 9, 9, 9, 9, 9, 7],
[7, 7, 7, 7, 7, 7, 7, 7, 7, 7, 7, 7, 0, 0, 0, 7, 7, 7, 7, 7, 7, 7, 7, 7, 7]],

"tiles":[
[0, 0, 0, 0, 0, 0, 0, 0, 0, 0, 0, 0, 0, 0, 0, 0, 0, 0, 0, 0, 0, 0, 0, 0, 0],
[0,11,11,11,11,11,11,11,11, 0, 9, 9, 9, 9, 9, 0,11,11,11,11, 0,11,11,11, 0],
[0,11,11,11,11,11,11,11,11, 0, 9, 9, 9, 9, 9, 0,11,11,11,11, 0,11,11,11, 0],
[0,11,11,11,11,11,11,11,11, 0, 9, 9, 9, 9, 9, 0,11,11,11,11, 0,11,11,11, 0],
[0,11,11,11,11,11,11,11,11, 0, 9, 9, 9, 9, 9, 0,11,11,11,11, 0,11,11,11, 0],
[0, 0, 0, 0, 0, 0, 0,11,11, 0, 0, 0, 9, 0, 0, 0, 0,11,11, 0, 0,11,11,11, 0],
[0,11,11,11,11,11, 0,11,11,11,11,11,11,11,11,11,11,11,11,11,11,11,11,11, 0],
[0,11,11,11,11,11, 0,11,11,11,11,11,11,11,11,11,11,11,11,11,11,11,11,11, 0],
[0,11,11,11,11,11, 0,11,11,11,11,11,11,11,11,11,11,11,11,11, 0, 0, 0, 0, 0],
[0,11,11,11,11,11, 0,11,11,11,11,11,11, 3,11,11,11,11,11,11, 0, 9, 9, 9, 0],
[0,11,11,11,11,11,11,11,11,11,11,11, 3, 2, 3,11,11,11,11,11, 9, 9, 9, 9, 0],
[0,11,11,11,11,11,11,11,11,11,11, 3, 2, 4, 2, 3,11,11,11,11, 9, 9, 9, 9, 0],
[0,11,11,11,11,11, 0,11,11,11,11,11, 3, 2, 3,11,11,11,11,11, 0, 9, 9, 9, 0],
[0,11,11,11,11,11, 0,11,11,11,11,11,11, 3,11,11,11,11,11,11, 0, 0, 0, 0, 0],
[0,11,11,11,11,11, 0,11,11,11,11,11,11,11,11,11,11,11,11,11, 0,11,11,11, 0],
[0, 0, 0, 0, 0, 0, 0,11,11,11,11,11,11,11,11,11,11,11,11,11, 0,11,11,11, 0],
[0,11,11,11,11,11, 0,11,11,11,11,11,11,11,11,11,11,11,11,11,11,11,11,11, 0],
[0,11,11,11,11,11, 0,11,11,11,11,11,11,11,11,11,11,11,11,11, 0,11,11,11, 0],
[0,11,11,11,11,11, 0,11,11,11,11,11,11,11,11,11,11,11,11,11, 0,11,11,11, 0],
[0,11,11,11,11,11,11,11,11,11,11,11,11,11,11, 0, 0, 0,11,11, 0, 0, 0, 0, 0],
[0,11,11,11,11,11,11,11, 0, 0,11, 0,11,11,11, 0, 9, 9, 9, 9, 9, 9, 9, 9, 0],
[0,11,11,11,11,11, 0,11, 0, 9, 9, 0,11, 0,11, 0, 9, 9, 9, 9, 9, 9, 9, 9, 0],
[0,11,11,11,11,11, 0,11, 0, 9, 9, 0,11,10,11, 0, 9, 9, 9, 9, 9, 9, 9, 9, 0],
[0,11,11,11,11,11, 0,11, 0, 9, 9, 0,11,11,11, 0, 9, 9, 9, 9, 9, 9, 9, 9, 0],
[0, 0, 0, 0, 0, 0, 0, 0, 0, 0, 0, 0,11,11,11, 0, 0, 0, 0, 0, 0, 0, 0, 0, 0]],

"entities":[
[ 0, 0, 0, 0, 0, 0, 0, 0, 0, 0, 0, 0, 0, 0, 0, 0, 0, 0, 0, 0, 0, 0, 0, 0, 0],
[ 0, 1, 0, 0, 0, 0, 0, 0, 0, 0, 0, 0, 0, 0, 0, 0, 0, 0, 0, 0, 0, 0, 0, 4, 0],
[ 0, 0, 0, 0, 0, 0, 0, 0, 0, 0, 0, 0, 0, 0, 0, 0, 0, 0, 0, 0, 0, 0, 0, 0, 0],
[ 0, 0, 0, 0, 0, 0, 0, 0, 0, 0, 0, 0, 0, 0, 0, 0, 0, 0, 0, 0, 0, 0, 0, 0, 0],
[ 0, 0, 0, 0, 0, 0, 0, 0, 0, 0, 0, 0, 0, 0, 0, 0, 0, 0, 0, 0, 0, 0, 0, 0, 0],
[ 0,10,10,10,10, 0, 0, 0, 0, 0, 0, 0, 0, 0, 0, 0, 0, 0, 0, 0, 0, 0, 0, 0, 0],
[ 0, 0, 0, 0, 0, 0, 0, 0, 0, 0, 0, 0, 0, 0, 0, 0, 0, 0, 0, 0, 0, 0, 0, 0, 0],
[ 0, 0, 0, 0, 0, 0, 0, 0, 0, 0, 0, 0, 0, 0, 0, 0, 0, 0, 0, 0, 0, 0, 0, 0, 0],
[ 0, 0, 0, 0, 0, 0, 0, 0, 0, 0, 0, 0, 0, 0, 0, 0, 0, 0, 0, 0,11,11,11,11, 0],
[ 0, 0, 0, 0, 0, 0, 0, 0, 0, 0, 0, 0, 0, 0, 0, 0, 0, 0, 0, 0, 0, 0, 0, 0, 0],
[ 0, 0, 0, 0, 0, 0, 0, 0, 0, 0, 0, 0, 0, 0, 4, 0, 0, 0, 0, 0, 0, 0, 0, 0, 0],
[ 0, 0, 0, 0, 0, 0, 0, 0, 0, 0, 0, 0, 0, 0, 0, 0, 0, 0, 0, 0, 0, 0, 0, 0, 0],
[ 0, 0, 0, 0, 0, 0, 0, 0, 0, 0, 0, 0, 0, 0, 0, 0, 0, 0, 0, 0, 0, 0, 0, 0, 0],
[ 0, 0, 0, 0, 0, 0, 0, 0, 0, 0, 0, 0, 0, 0, 0, 0, 0, 0, 0, 0, 0, 0, 0, 0, 0],
[ 0, 0, 0, 0, 0, 0, 0, 0, 0, 0, 0, 0, 0, 0, 0, 0, 0, 0, 0, 0, 0, 0, 0, 0, 0],
[ 0, 9, 9, 9, 9, 0, 0, 0, 0, 0, 0, 0, 0, 0, 0, 0, 0, 0, 0, 0, 0, 0, 0, 0, 0],
[ 0, 0, 0, 0, 0, 0, 0, 0, 0, 0, 0, 0, 0, 0, 0, 0, 0, 0, 0, 0, 0, 0, 0, 0, 0],
[ 0, 0, 0, 0, 0, 0, 0, 0, 0, 0, 0, 0, 0, 0, 0, 0, 0, 0, 0, 0, 0, 0, 0, 0, 0],
[ 0, 0, 0, 0, 0, 0, 0, 0, 0, 0, 0, 0, 0, 0, 0, 0, 0, 0, 0, 0, 0, 0, 0, 0, 0],
[ 0, 0, 0, 0, 0, 0, 0, 0, 0, 0, 0, 0, 0, 0, 0, 0, 0, 0, 0, 0, 8, 8, 8, 8, 0],
[ 0, 0, 0, 0, 0, 0, 0, 0, 0, 0, 0, 0, 0, 0, 0, 0, 0, 0, 0, 0, 0, 0, 0, 0, 0],
[ 0, 0, 0, 0, 0, 0, 0, 0, 0, 0, 0, 0, 0, 0, 0, 0, 0, 0, 0, 0, 0, 0, 0, 0, 0],
[ 0, 0, 0, 0, 0, 0, 0, 0, 0, 0, 0, 0, 0,"home", 0, 0, 0, 0, 0, 0, 0, 0, 0, 0, 0],
[ 0, 4, 0, 0, 0, 0, 0, 0, 0, 0, 0, 0, 0, 0, 0, 0, 0, 0, 0, 0, 0, 0, 0, 0, 0],
[ 0, 0, 0, 0, 0, 0, 0, 0, 0, 0, 0, 0, 0, 0, 0, 0, 0, 0, 0, 0, 0, 0, 0, 0, 0]],

"units":[
["cheer",5,10],
["prep",11,3],
["prep",11,18],
["grease",18,18],
["cheer",17,7]],
"effects":[]

}


