{"background":"hospital.png","music":"kuwait.ogg","intel":6,
"intro":["I am not feeling up to giving you ","detailed instructions. ","",
"Wicked hangover from the let's invade ","Iraq party last night.","",
"We need you to go check out the whole ","incubator babies thing. We are gonna ",
"drop you on the roof of this hospital.","","Get in get the Intel.","",
"Get out the front door.","","Don't get shot.","","The 90's man. The 90's."],
"world":[[0,0,0,0,0,0,0,0,0,0,0,0,0,0,0,0,0,0,0,0],
[14,0,0,0,0,7,0,0,0,0,0,0,0,0,0,0,0,0,0,14],
[14,0,0,0,0,7,7,0,0,0,-1,0,0,7,7,0,0,0,0,14],
[8,8,8,8,0,8,8,8,8,8,8,8,8,8,8,8,8,8,8,8],
[2,0,0,0,0,0,0,0,0,0,0,0,0,0,0,0,0,0,-7,2],
[2,0,0,0,0,0,0,0,-3,0,-3,0,0,0,0,0,0,0,-7,2],
[2,0,0,0,0,0,14,14,14,14,14,14,14,-7,0,0,0,0,-7,2],
[14,0,0,0,0,0,0,0,0,0,0,0,0,-7,0,0,7,0,-7,14],
[14,0,7,0,0,0,0,0,0,0,0,0,0,-7,0,0,7,0,-7,14],
[14,-7,14,14,14,14,14,14,14,14,14,14,14,14,14,14,14,0,-7,14],
[2,-7,0,0,14,0,0,0,0,0,0,0,14,0,0,0,14,0,-7,2],
[2,-7,0,0,14,0,0,0,0,0,0,0,14,-5,-5,-5,14,0,-7,2],
[2,-7,0,0,0,0,0,7,7,0,0,0,0,-5,-4,-5,14,0,-7,2],
[14,14,14,14,14,14,14,14,14,14,14,14,14,14,14,14,14,0,-7,14],
[2,-3,-3,-3,0,3,0,0,0,0,0,0,0,0,0,0,14,0,-7,2],
[2,-3,-3,-3,0,3,0,0,0,0,0,0,0,0,0,0,7,0,-7,2],
[2,-3,-3,-3,-4,0,0,0,3,0,0,0,3,0,0,0,7,0,-7,2],
[14,14,14,14,14,14,14,14,14,14,14,14,14,14,14,14,14,0,-7,14],[2,0,0,0,0,14,0,0,0,0,14,0,0,0,0,0,14,0,-7,2],[2,0,0,0,0,14,0,0,0,0,14,0,0,0,0,0,7,0,-7,2],[2,4,4,0,0,14,4,4,0,0,14,0,0,3,0,0,7,0,-7,2],[14,14,14,14,14,14,14,14,14,14,14,14,14,14,14,14,14,0,-7,14],[14,0,0,0,0,0,0,0,0,0,0,0,0,0,0,0,0,0,-7,14],[14,0,0,0,0,0,0,0,0,0,0,0,0,0,0,0,0,0,-7,14],[14,0,0,0,0,0,0,0,0,0,0,0,0,0,0,0,0,7,7,14],[14,-7,14,14,0,0,14,0,0,14,14,14,0,0,14,14,14,7,7,14],[14,-7,14,4,0,0,0,0,0,0,0,0,0,0,0,0,7,0,0,14],[14,-7,14,4,4,0,0,0,0,0,0,0,0,0,0,0,7,0,0,14],[14,-7,14,14,14,14,14,14,14,14,14,14,14,14,14,14,14,0,0,14],[14,-7,14,0,0,0,0,0,0,0,0,0,0,0,0,0,14,0,0,14],[14,-7,0,0,0,0,0,0,0,0,0,0,0,0,0,0,7,0,0,14],[14,-7,0,0,0,3,0,0,0,0,0,3,0,0,0,0,0,0,-7,14],[14,14,14,14,14,14,14,14,14,14,14,14,14,14,14,14,14,0,-7,14],[14,0,0,0,0,0,13,13,13,13,13,0,0,0,0,0,14,0,-7,14],[14,0,0,0,0,0,13,13,13,13,13,0,0,0,0,0,7,0,-7,14],[0,0,0,0,0,0,0,0,0,0,0,0,0,0,0,0,0,0,-7,14],[-2,0,0,3,0,0,0,0,0,0,0,0,0,3,0,0,0,0,-7,14],[14,14,14,14,14,14,14,14,14,14,14,14,14,14,14,14,14,14,14,14]],
"units":[["crawler","5","8"],["crawler","12","19"],["shooter","9","27"],["shooter","14","27"]],
"effects":[["text","8","34","0","HOSPITAL"]]}
