{
	"background":"mountain.jpg",
	"music":"",
	"intel":5,
	"intro": ["Hack teh computer on teh top floor for intel."],
	"world":[
		[3, 3, 3, 3, 3, 3, 3, 3, 3, 3, 3, 3, 3, 3, 3],
		[3,-5,-5, 0, 0, 0, 0, 0, 0, 0, 0, 0, 0, 0, 3],
		[3,-5,-5, 0, 0, 0, 0, 0, 0, 0, 0, 0, 0, 0, 3],
		[3,-5, 0, 0, 0, 0, 0, 0, 0, 0, 0, 0, 0, 0, 3],
		[3,-4, 0, 0, 0, 0, 0, 0, 0, 0,-7, 0, 0, 0, 3],
		[3, 1, 1, 1, 1, 1, 1, 1, 1, 1,-7, 0, 0, 0, 3],
		[3, 0, 0, 0, 0, 0, 0, 0, 0, 0,-7, 0, 0, 2, 3],
		[3, 0, 0, 0, 0, 0, 0, 0, 0, 0,-7, 0, 2, 3, 3],
		[3, 0, 0, 0, 1, 1, 1, 1, 1, 1,-7, 1, 1, 1, 3],
		[3, 2, 0, 0, 0, 0,-3, 0, 0, 0,-7, 0, 0, 0, 3],
		[3, 3, 2, 0, 0, 0, 0, 0, 0, 0,-7, 0, 0, 0, 3],
		[3, 1, 1, 1, 1, 1, 1, 1, 1, 1, 1, 0, 0, 0, 3],
		[3, 0, 0, 0, 0, 0, 0, 0, 0, 0, 0, 0, 0, 2, 3],
		[3, 0, 0, 0, 0, 0, 0, 0, 0, 0, 0, 0, 2, 2, 3],
		[3, 3, 3, 3, 3, 3, 3, 3, 0, 0, 0, 2, 3, 3, 3],
		[3,-1, 0, 0, 0, 0, 0, 0, 0, 0, 2, 2, 0, 0, 3],
		[3,-2, 0, 0, 0, 0, 0, 0, 0, 2, 0, 2, 0, 0, 3],
		[3, 3, 3, 3, 3, 3, 3, 3, 3, 3, 3, 3, 3, 3, 3]
	
	],
	"units":[

		["crawler",5,13]
		
	],
	"effects":[
		["text",10,10,0,"test"],
		["text",20,20,0,"test"]
	]

}

